protein	measure
 gene	instrument
optical	humans
light	encoded
cell	measuring
magnetic	gas
drug	human
DNA	imaging
opioid	measures
cells	equipment
acid	member
compound	chemistry
blood	biology
energy	telescope
electric	object
mass	receptors
electrical	detect
nuclear	camera
molecule	body
electromagnetic	transcription
liquid	spectroscopy
molecules	instruments
quantum	microscopy
electron	beam
enzyme	objects
medical	measured
antagonist	size
analgesic	microscope
 gas	machine
RNA	aircraft
 ion	ion
amino	effects
membrane	eg
hydrogen	detector
materials	physics
atomic	motor
signal	synthetic
measurement	disease
fluorescent	lens
resonance	software
peptide	element
electronic	manufacturer
data	survey
cytokine	abbreviated
compounds	clock
bacteria	spectrometry
emission	satellite
information	sequencing
bacterium	signaling
atom	filter
power	electronics
nucleic	scanning
glycoprotein	scattering
carbon	transformer
atoms	medication
ions	chromatography
concentration	ie
antibody	derivative
field	navigation
bacterial	astronomical
chemokine	display
receptor	radar
biochemical	observatory
absorption	nm
agonist	sensors
fiber	xray
spectral	chain
proteins	andor
diffraction	converts
plasma	caused
fluorescence	database
spin	sensing
sensor	genome
protein-coupled	probe
metal	built
cellular	land
hormone	weather
space	construction
mechanical	animals
ionization	mri
Gram-negative	generator
glutamate	tomography
oil	audio
NMDA	nmr
fluid	meter
antibiotic	assay
polymer	health
particle	microphone
inorganic	manufactured
kinase	ph
glass	engine
digital	gramnegative
pharmaceutical	surveying
blood	spectrometer
volume	biotechnology
stain	transistor
plants	detecting
pH	vehicle
microscopic	apparatus
activated	french
voltage	endogenous
temperature	ground
surfaces	nmda
silicon	subfamily
semiconductor	proteincoupled
organism	staining
nitrogen	manufacturing
immune	coupled
eukaryotic	precision
electrode	angles
acids	genetically
waves	telescopes
wavelength	binds
tissues	inc
protein	navy
G-protein	english
extracellular	etc
photons	formed
pain	wind
MRI	earths
ligand	times
gel	combines
enzymes	convert
electrons	gauge
chromosome	atmospheric
calcium	vessel
aromatic	rotation
water	population
tyrosine	interface
thermal	physicist
"protein,"	spacecraft
pressure	compass
aminoglycoside	born
allosteric	dc
affinity	interferometer
transmembrane	circuits
signals	interference
nanoscale	latin
metabotropic	wavelengths
metabolic	communication
messenger	emitted
isotope	diagnosis
infrared	spectroscopic
glucose	war
drugs	microphones
circuit	distillation
adhesion	view
transparent	top
diagnostic	experiment
analog	sequences
agar	rotating
adenosine	meteorological
soil	ac
salt	astronomy
polarization	superfamily
oxygen	eye
NMR	headquartered
nerve	machines
hemoglobin	receiver
antibodies	coupling
alkaloid	biochemistry
"acid,"	wireless
3D	temperatures
tumor	ocean
refractive	detects
nucleotide	record
network	heart
modulator	wire
liver	winding
gases	actuator
distance	ci
bone	extraction
antigen	obtained
sodium	transducer
psychrophilic	antenna
propagation	spatial
polymerase	balance
peptides	pathway
optics	platform
nanometer	recombinant
indicator	russian
fuel	threedimensional
film	torque
charge	filtration
brain	records
angular	rotary
_-opioid	separating
vector	prevent
titration	reflecting
Streptomyces	induction
spectra	ship
radio	motors
"plants,"	vessels
microbial	diode
crystalline	tools
coil	therapy
cavity	gravitational
cancer	filters
bacteria	ltd
azo	chamber
aerobic	civil
two-dimensional	biomedical
solute	scientist
redox	amplification
proteoglycan	differential
photon	alternating
neurotrophic	canada
mixtures	nasa
mineral	muscle
hydrocarbon	nonlinear
heat	electrically
fluids	noninvasive
environmental	persons
aqueous	automated
analyte	mathematical
AMPA	displacement
_-opioid	inventor
"tissue,"	detectors
three-dimensional	generates
sugar	dog
nanotechnology	thermometer
molecule	tree
metallic	cameras
membranes	ec
lipid	photographic
intracellular	transformers
fungi	physiological
equilibrium	rotational
electrochemical	ambient
dielectric	death
copper	steam
alpha	electromechanical
activation	purification
virus	satellites
vacuum	mammalian
plasmid	gprotein
particles	mosfet
nucleus	ionizing
metabolite	analyze
liquids	portable
Gram-negative	distances
deuterium	addition
DC	fire
coherent	grampositive
X-ray	mrna
xanthine	utilizes
ultraviolet	manufactures
superconducting	kda
substrate	multinational
pulsed	orientation
porous	lightemitting
polycyclic	ct
points	february
petroleum	junction
morphinan	causes
microorganisms.	electrophoresis
metals	inertial
Gram-positive	doppler
"genes,"	kinetic
fiber.	takes
energy	art
dyes	twodimensional
cyclic	illumination
compound	magnet
chemicals	cloning
beta	cc
Arthrobacter	chinese
AC	usan
zinc	trademark
vitamin	train
therapeutic	ships
sulfate	tape
steroid	head
polypeptide	battery
polymers	pcr
polarized	cosmic
neutron	box
milk	dutch
microorganisms	lab
iron	datum
inhibits	stem
influenza	computed
inflammatory	symbol
immunoglobulin	combustion
gaseous	airport
gamma	nonmotile
fatty	sensory
conductor	communications
chloride	urine
benzomorphan	england
"atoms,"	fieldeffect
antidepressant	reactor
yeast	mapping
viruses	oxidation
triarylmethane	stores
transitions	beams
terahertz	hardware
solvent	pulses
solids	television
skin	neurons
"receptors,"	subunit
reagent	apoptosis
radioactive	aperture
positron	engineer
paper	community
optic	pathways
mRNA	selectively
mitochondria	mobile
magnetic	_opioid
lipids	diseases
kainate	spectrograph
inositol	transmitter
glycine	propulsion
forces	secreted
field	metabolism
fibers	resistor
exhaust	map
epithelial	_m
energy	diffusion
dynorphin	gpcr
dioxide	maps
cytokines	problem
crystals	mechanics
cold	screening
anesthetic	perpendicular
anaerobic	india
amorphous	transform
alloy	traffic
air	colloquially
aerobic	nonprofit
acid	channels
volumetric	carried
vapor	lenses
stimulant	psychrotolerant
specimen	astronomer
somatic	regulatory
Resonance	analogue
reactants	bond
platelet	dispersion
plasmon	genomes
photonic	seaplane
phosphatase	pet
oxide	collaboration
nucleotides	hypothetical
nuclei	computational
neurotransmitter	calculate
necrosis	prism
mitochondrial	added
mercury	bodies
ionic	move
hot	rotor
haemoglobin	largescale
electrostatic	spelled
alcohol	rings
proton	acronym
phage	thyroid
ligands	rod
hydrophobic	cxc
hydrophilic	hybrid
ester	transmit
piezoelectric	reactive
opaque	contamination
nucleoside	calibration
dna	organ
frequency	excitation
rna	conjugate
resistance	conductivity
frequencies	computing
electricity	bonds
acoustic	windings
noise	metaloxidesemiconductor
microwave	watch
xrays	analyzing
neutrons	highresolution
solvents	diodes
conductive	mars
biomolecules	serum
iodine	cone
macrophages	networks
macromolecules	regulate
ferromagnetic	minerals
pathogens	microarray
holographic	photovoltaic
thermodynamic	room
electrostatic	infection
acceleration	agricultural
